WW W W              W W WW
WWWWWW              WWWWWW
 WWWW   WWW   WWW    WWWW
 WWWWWWWWWWWWWWWWWWWWWWWW
 WWCWWWWDDWWCCWWDDWWWWCWW
 WWOWOWDDDDWWWWDDDDWOWOWW
 WWWWWWDDDDWWWWDDDDWWWWWW
